6 . HÀN MÔN:
Ôn pháp gồm ôn trung khư hàn và hồi dương cứu nghịch. 
Thích hợp với trường hợp trị liệu lý hàn.
Lý hàn chứng gồm có ngoại hàn trực nhập lý, có nguyên nhân dùng dược sau mà tổn thương dương khí hoặc nhân nguyên dương bất túc hàn theo trong mà sinh ra. 
Lâm sàng căn cứ vào mức độ lý hàn không giống nhau. 
Cho nên ôn pháp chia hai loại: ôn trung khư hàn và hồi dương cứu nghịch.

+ ôn trung khử hàn: thích hợp dùng với trường hợp tỳ vị hư hàn. 
Tỳ vị ở vị trí trung tiêu, tức chủ vận hóa. Nếu tỳ vị hư hàn, thì xuất hiện chi thể mệt mỏi, ăn uống không hưng phấn, bụng đau nôn tả, tứ chi không ấm.

+hồi dương cứu nghịch: thích hợp dùng trị liệu âm thịnh dương suy, dương khí vong. 
Bệnh tật phát triển khiến dương khí suy vi, âm hàn nội thịnh, xuất hiện tứ chi quyết lạnh, sợ lạnh mệt mỏi, nôn mửa hạ lợi, mạch trầm. 
Có thể dùng cứu pháp để điều trị.
Tổng lại, hàn môn có ôn trung, ôn dương, tán hàn, cứu nghịch làm chủ . Tổng cộng có 24 huyệt.


Trung quản: Ôn trung noãn vị, khử nội hàn
Khí hải: Ôn trung tán hàn, noãn vị trường
Túc tam lý: Ôn trung tán hàn, noãn vị trường
Thần khuyết (cửu): Ôn trung ấm vị trường, trợ dương tán hàn
Tam âm giao: Ôn trung hạ tiêu, ấm huyết hàn
Khúc tuyền: Lý huyết hàn, ấm trung tiêu
Đản trung: Ôn trung tán bưng
Lệ đoài: Ôn vị ấm trung tiêu
Công tôn: Ôn trung ấm bụng

Quan nguyên: Ôn hạ tiêu, noãn tử cung (ấm tử cung)
Thận du: Ôn thận, ấm hạ tiêu
Quy lai: Ôn hạ nguyên, noãn can hàn
Đại đôn: Noãn can hàn, ôn hạ nguyên

Dũng tuyền: Ôn thận trợ dương
Nhiên cốc: Ôn can noãn thận, trừ mệnh hỏa hàn


Đại truy: Phát tán biểu tà
Chương môn: Ôn ấm táng hàn
Liệt khuyết: Ôn phế kinh hàn
Bách hội: Trợ dương tán hàn ở đầu
Dương lăng tuyền: Ôn kinh, ấm tất hàn (gối lạnh)
Ấn bạch: Ôn âm tạng, tráng dương đoạn hàn
Hậu khuê: Phát tán biểu hàn, khử bối hàn
Cao hoang: Ôn tạng hàn, khử bối hàn
Khúc trì: Ôn kinh tán hàn, khử khuỷu tay lạnh
