Chất lưỡi và rêu lưỡi

Chất lưỡi
Nhạt màu: hàn, hư chứng; dương khí suy hoặc khí huyết k đầy đủ
Đỏ : nhiệt có thực nhiệt hoặc hư nhiệt ( âm hư hỏa vượng ), nếu đỏ rêu vàng mỏng hoặc dày thì thực nhiệt, đỏ ít rêu, không rêu, rêu bông tróc là hư nhiệt
Đỏ giáng: Nhiệt thịnh, tà khí vào dinh thường ở bệnh nhân âm hư hoặc tân dịch suy giảm nhiều
Xanh, tím: hàn hoặc nhiệt, Nếu xanh tím mà khô là nhiệt; xanh tím ướt là hàn
Tím nhạt: âm hàn nội thịnh, khí huyết không thông hoặc khí huyết hư kèm huyết ứ
Điểm ứ huyết + xanh tím: huyết ứ 

Dáng lưỡi: 
Phù nề: thực chứng, nhiệt chứng
Có vết răng: hư hàn hoặc đàm kết 
sưng to trắng nhợt: tỳ thận dương hư, tân dịch không hóa, thủy thấp đình trệ
sưng to hồng đỏ: thấp nhiệt, nhiệt độc mạnh
Nhỏ, ướt: tâm tỳ khí hư, khí huyết hư suy 
Mỏng, nhỏ, đỏ giáng: âm hư nhiệt thịnh, tân dịch hao tổn
Đầu lưỡi phì đại: tâm hỏa thịnh , 2 bên phì đại: can đởm hỏa vượng , giữa lưỡi phì đại: vị nhiệt 
Lưỡi có dấu máu: thực nhiệt hoặc hư nhiệt hoặc khí hư
Lưỡi có vết loét: tâm hỏa vượng, âm hư hỏa vượng, khí huyết lưỡng hư ( xem tâm hỏa và vị nhiệt )

Động thái lưỡi:
Yếu, nhợt: khí huyết hư
liệt, đỏ: âm hư kiệt
liệt đỏ xẫm: nhiệt thịnh tổn âm 
cứng không cử động được: nhiệt nhập tâm bào
run: tâm tỳ huyết hư hoặc can phong nội động ( trắng nhạt do huyết hư, tím giáng do nhiệt động hoặc can dương hóa phong )

lưỡi rụt: bệnh trầm trọng, nếu ướt là hàn ngưng tụ trệ ở cân mạch, phù nề là đàm thấp, nếu đỏ là nhiệt thịnh thương âm

Tĩnh mạch dưới lưỡi: Bình thường không dài quá 3/5 độ dài dưới lưỡi, tím nhạt
Tĩnh mạch dưới lưỡi đan vào nhau hoặc quá to màu tím: khí huyết ứ trệ
Tĩnh mạch dưới lưỡi có điểm ứ huyết: huyết ứ có thể do nguyên nhân như huyết hàn, huyết nhiệt, khí trệ, đàm thấp, dương hư

Rêu lưỡi: 
lưỡi không rêu, không gai, không ẩm ướt hoặt hơi rát như bình thường: chân âm can thận thiếu
rêu lưỡi dính, hôi: trường vị có nhiệt, thực tích ứ trệ tỳ vị
rêu mỏng nhìn thấy được chất lưỡi: trạng thái bình thường hoặc bệnh còn ở biểu

trắng mỏng: phong hàn
trắng mỏng đầu lưỡi đỏ: phong nhiệt
trắng trơn: thấp hoặc đàm thấp
trắng dính: đàm trọc thấp tà gây ra
trắng khô nứt nẻ: tà nhiệt trong thịnh, tân dịch hao tổn nhiều

Vàng (Lý chứng, nhiệt chứng)
Vàng mỏng: nhiệt ở lý nhẹ
Vàng dày khô: nhiệt ở lý thịnh, tân dịch hao tổn, vị nhiệt thương âm
Vàng dính: thấp nhiệt hoặc đàm nhiệt 
Vàng dày mà nhẵn: tỳ vị thấp nhiệt, tỳ vị tích trệ
Vàng khô gai đen hoặc vết nứt: nhiệt nặng, khí và âm bị tổn thương

Đen: Bệnh nặng
xám đen khô: nhiệt thịnh, tân dịch hao tổn nhiều
xám đen trơn nhuận: dương hư, hàn thịnh, thủy thấp ứ trệ bên trong


